#############
#   E       #
# ### WWWWWW#
# #    #WWWW#
#  #####    #
# #  # #  # #
#    # #  # #
# #    #  # #
# ######  # #
#      #  #E#
# ### ### ###
# P   #     #
#############
