#############
#           #
# ### WWWWWW#
# #    #WWWW#
#  #####    #
# #  # #  # #
#    # #  # #
# #    #  # #
# ######  # #
#      #  #E#
# ### ### ###
# P   #     #
#############