#############
# W         #
# W   ####  #
# W    #    #
#  #####    #
# #   W   # #
#     W   # #
# #       # #
# #####   # #
#         #E#
# ###########
# P   #     #
#############