#############
#EEEEEEEEEEE#
#           #
#           #
#           #
#           #
#WWWWWWWWWWW#
#           #
#           #
#           #
#           #
#     P     #
#############